0000001000000100000000000000000010000001000000000000
0001000000000100000000001100010000000001000000000011
0000000001000000010000100000000000010000000100001000
0000000010000001000100000000000000100000010001000000
0000000100000000000000000000000001000000000000000000
0000000001000000000000001000000000010000000000000010
0100000000000000000000010001000000000000000000000100
0000100000000100000000000000001000000001000000000000
0000000100000000000000010000000001000000000000000100
0000010000000000000000010000000100000000000000000100
0001000000000000000100000000010000000000000001000000
0100000000000100000000100001000000000001000000001000
1000000000000001000001000110000000000000010000010001
1000000000000100000100001010000000000001000001000010
